..........................................................................................................................................................................................................................................................
..........................................................................................................................................................................................................................................................
..........................................................................................................................................................................................................................................................
..........................................................................................................................................................................................................................................................
..........................................................................................................................................................................................................................................................
..........................................................................................................................................................................................................................................................
..........................................................................................................................................................................................................................................................
..........................................................................................................................................................................................................................................................
..........................................................................................................................................................................................................................................................
..............................................................................---....................................................---..................................................................................................................
.............................................................................-----...................................................---..................................................................................................................
.....................................................................-...---------..........--.......................................---..................................................................................................................
...................................................................----..--------........----........................................----.................................................................................................................
......----........................................................-----..--------......----..........................................----.................................................................................................................
.............---.---.............................................-----...-----.-......-----..........................................----.................................................................................................................
...-.-.--.--.-.-.---.............................................----...----........------...........................................----.................................................................................................................
.....-....--.-.-.---........................-.............----....-----------......-------...........................................----.................................................................................................................
............................................--..........--------...-----------......-----............................................-----................................................................................................................
.............................................--........----------....----------.........--...........................................--..-................................................................................................................
.............................................----------------------...-----------....................................................--..--...............................................................................................................
.............................................-----------------------...-----------...................................................--..--...............................................................................................................
...........................................--------------------------....-----------................................................----.--...............................................................................................................
............................................-------------------------......--------------............................................------...............................................................................................................
....................................................-------------------......-------------------.....................................------...............................................................................................................
......................................................-------------------.......-----------------...................................------................................................................................................................
............................................................-----------------......--------------...................................---...................................................................................................................
................................................................---------------.....-------------...................................------................................................................................................................
..........................................-......................----------------....------------...................................-------...............................................................................................................
..........................................--......................------------------..-----------...................................-------...............................................................................................................
...........................................-..........---------........--------------..----------...................................--------..............................................................................................................
...........................................-..........-------------......-------------...-------....................................---------.--..........................................................................................................
............................................-.......----------------------------------....-----.........................................-------.....................................--....................................................................
............................................-........---------------------------------...................................................------.....................................--....................................................................
............................................-.------.---------------------------------....................................................-----.....................................--....................................................................
.............................................------------.........-------------------.......................................................---......................................-....................................................................
.............................................--.--.-----............----------------......................................................................................................................................................................
........................................................................------............................................................................................................................................................................
..........................................................................................................................................................................................................................................................
..........................................................................................................................................................................................................................................................