.........................
.........................
.........................
.........................
.........................
.........................
.........................
.........................
.........................
.........................
.........................
.........................
.....-............-......
.........................
.........................
.........................
.........................
.........................
.........................
XXXXXXXXXXXXXXXXXXXXXXXXX