.........................
.........................
.........................
.........................
.........................
.........................
.........................
.........................
.........................
.........................
.........................
..........-.-.-..........
........-.......-........
.........................
...=..............=.....2
1.X...................X..
..X...................X..
.........................
-.......................-
XXXXXXXXXXXXXXXXXXXXXXXXX
.........................
.........................
.........................
.........................
.........................